
===============
Bug
===============
Quiver Dance : Status / -- / -- : Raises user's Sp.Atk, Sp.Def and Speed by 1 stage
Sticky Web : Status / -- / -- : Lays webs on opponents side. This will cause a grounded foe switching in to have their Speed lowered by 1 stage
String Shot : Status / -- / 100 : Lowers foe's Speed by 2
Tail Glow : Status / -- / -- : Raises user's Sp.Atk by 3

===============
Dark
===============
Fake Tears : Status / -- / 100 : Lowers foe's Sp.Def by 2
Flatter : Status / -- / 100 : Confuses foe, and raises their Sp.Atk by 2
Hone Claws : Status / -- / -- : Raises user's Attack and Accuracy by 1
Memento : Status / -- / 100 : User faints. Foe's Attack and Sp.Atk are lowered by 2 stages
Nasty Plot : Status / -- / -- : Raises user's Sp.Atk by 2
Obstruct : Status / -- / -- : User protects itself, can't be used in succession. Lowers foe's Defense by 2 if they make contact
Taunt : Status / -- / 100 : Causes foe to only be able to use attacking moves for 4 turns
Topsy-Turvy : Status / -- / -- : Inverses every stat change the foe has
Torment : Status / -- / 100 : Causes foe to not be able to use the same move in succession for 4 turns

===============
Dragon
===============
Dragon Dance : Status / -- / -- : Raises user's Attack and Speed by 1

===============
Electric
===============
Charge : Status / -- / -- : User's next electric-type attack damage is doubled. Raises user's Sp.Def by 1
Electric Terrain : Status / -- / -- : Sets the terrain to ELECTRIC for 8 turns
Thunder Wave : Status / -- / 90 : Paralyzes foe

===============
Fighting
===============
Bulk Up : Status / -- / -- : Raises user's Attack and Defense by 1
Detect : Status / -- / -- : Protects user, can't be used in succession
No Retreat : Status / -- / -- : Raises all of user's stats by 1, user can't switch out. Can only be used once

===============
Fire
===============
Molten Lair : Status / -- / 100 : User protects itself, can't be used in succession. Burns foe if they make contact
Sunny Day : Status / -- / -- : Changes the weather to SUNNY for 8 turns
Will-O-Wisp : Status / -- / 85 : Burns foe

===============
Flying
===============
Agility : Status / -- / -- : Raises user's Speed by 2
Defog : Status / -- / -- : Lowers foe's Evasion by 1, clears all hazards and screens from both sides
Feather Dance : Status / -- / 100 : Lowers foe's Attack by 2
Mirror Move : Status / -- / -- : Uses the move last used by the foe, fails if foe hasn't used a move yet
Roost : Status / -- / -- : Restores 1/2 of user's max HP
Tailwind : Status / -- / -- : Doubles Speed for user's team for 5 turns
Whirlwind : Status / -- / -- : Forces foe to switch out to a random teammate

===============
Galactic
===============
Abduct : Status / -- / 100 : Abducts the foe and forces their next move to be used on themselves. Can be used once every other turn
Cosmic Power : Status / -- / -- : Raises user's Def and Sp.Def by 1
Gravity : Status / -- / -- : Sets GRAVITY for 6 turns, in which the accuracy of all Pokemon is increased

===============
Ghost
===============
Confuse Ray : Status / -- / 100 : Confuses foe
Curse : Status / -- / 100 : User loses half of its total HP. In exchance, foe takes 1/4 of its max HP at the end of every turn
Destiny Bond : Status / -- / -- : Always goes first; can't be used twice in a row. If foe knocks out user the same turn, foe faints as well
Minimize : Status / -- / -- : Raises user's Evasion by 2
Nightmare : Status / -- / 100 : Foe loses 1/4 of max HP each turn; wears off when foe wakes up
Perish Song : Status / -- / -- : All Pokemon hearing this song will faint in 3 turns
Take Over : Status / -- / 100 : Foe's next attack is used on itself. Can be used once every other turn

===============
Grass
===============
Aromatherapy : Status / -- / -- : Cures team of any status conditions
Cotton Guard : Status / -- / -- : Raises user's Defense by 3
Forests Curse : Status / -- / 100 : Changes foe's type to GRASS
Grass Whistle : Status / -- / 55 : Foe falls asleep
Grassy Terrain : Status / -- / -- : Sets the terrain to GRASSY for 8 turns
Growth : Status / -- / -- : Raises user's Attack and Sp.Atk by 1
Ingrain : Status / -- / -- : Restores a small amount of HP at the end of every turn, user can't switch out
Leech Seed : Status / -- / 90 : At the end of every turn, user steals 1/8 of foe's max HP
Sleep Powder : Status / -- / 75 : Foe falls asleep
Spiky Shield : Status / -- / -- : User protects itself, can't be used in succession. Damages foe if they make contact
Strength Sap : Status / -- / 100 : Heals user an HP amount equal to foe's Attack stat; lowers foe's Attack by 1
Stun Spore : Status / -- / 75 : Paralyzes foe
Synthesis : Status / -- / -- : Restores 1/2 of user's max HP, 2/3 in SUN, 1/4 in any other weather
Worry Seed : Status / -- / 100 : Changes foe's ability to INSOMNIA

===============
Ground
===============
Mud Sport : Status / -- / -- : Makes ELECTRIC moves deal 1/3 damage for 8 turns
Sand Attack : Status / -- / 100 : Lowers foe's Accuracy by 1
Spikes : Status / -- / -- : Lays spikes on the opponents side. Depending on the layers laid (1-3) will damage any grounded foe (1/8, 1/6, 1/4) upon switch-in

===============
Ice
===============
Aurora Veil : Status / -- / -- : Can only be used in SNOW, reduces both physical and special damage on user's team recieved for 5 turns
Haze : Status / -- / -- : Clears all stat changes on the field
Snowscape : Status / -- / -- : Sets the weather to SNOW for 8 turns

===============
Light
===============
Baby-Doll Eyes : Status / -- / 100 : Lowers foe's Attack by 1, moves first
Charm : Status / -- / 100 : Lowers foe's Attack by 2
Flash : Status / -- / 100 : Lowers foe's Accuracy by 1, and raises user's Sp.Atk by 1
Geomancy : Status / -- / -- : Charges on the first turn, raises user's Sp.Atk, Sp.Def and Speed by 2 on the second
Glitter Dance : Status / -- / -- : Raises user's Sp.Atk and Speed by 1
Moonlight : Status / -- / -- : Restores 1/2 of user's max HP, 2/3 in SUN, 1/4 in any other weather
Morning Sun : Status / -- / -- : Restores 1/2 of user's max HP, 2/3 in SUN, 1/4 in any other weather
Sweet Kiss : Status / -- / 75 : Confuses foe

===============
Magic
===============
Foresight : Status / -- / -- : Indentifies foe, replacing their Ghost typing with Normal if they have it. It also raises user's Accuracy by 1 stage
Magic Powder : Status / -- / 100 : Changes foe's type to MAGIC
Magic Reflect : Status / -- / -- : Foe's next attack will be reflected against them. Can be used every other turn
Metronome : Status / 0 / -- : Uses a random move!
Red-Nose Boost : Status / -- / -- : Raises user's Defense and Sp.Def by 1, and user's Sp.Atk by 2
Sea Dragon : Status / -- / -- : Transforms Kissyfishy into Kissyfishy-D
Sparkling Terrain : Status / -- / -- : Sets the terrain to SPARKLY for 8 turns

===============
Normal
===============
Baton Pass : Status / 0 / 100 : Causes user to switch and passes all stat changes with it
Captivate : Status / 0 / 100 : Lowers foe's Sp.Atk by 2
Defense Curl : Status / -- / -- : Raises user's Defense by 1
Double Team : Status / -- / -- : Raises user's Evasion by 1
Encore : Status / -- / 100 : Causes foe to use their last used move for 4 turns
Endure : Status / -- / -- : The user will survive on at least 1 HP from the next attack. Can't be used in succession
Entrainment : Status / -- / 100 : Changes foe's ability to the user's
Focus Energy : Status / -- / -- : Boosts the user's crit rate by 2
Glare : Status / -- / 100 : Paralyzes foe
Growl : Status / -- / 100 : Lowers foe's Attack by 1
Harden : Status / -- / -- : Raises user's Defense by 1
Howl : Status / -- / -- : Raises user's Attack by 1
Leer : Status / -- / 100 : Lowers foe's Defense by 1
Lock-On : Status / -- / -- : Raises user's Accuracy by 6
Lovely Kiss : Status / -- / 75 : Sleeps foe
Mean Look : Status / -- / 100 : Causes foe to be unable to switch
Noble Roar : Status / -- / 100 : Lowers foe's Attack and Sp.Atk by 1
Odor Sleuth : Status / -- / -- : Indentifies foe, replacing their Ghost typing with Normal if they have it. It also lowers foe's Evasion by 1
Play Nice : Status / -- / 100 : Lowers foe's Attack by 1
Protect : Status / -- / -- : Protects user, can't be used in succession
Recover : Status / -- / -- : Restores 1/2 of user's max HP
Roar : Status / -- / -- : Forces foe to switch out into a random teammate
Safeguard : Status / -- / -- : Protects user's team from Status effects for 8 turns
Scary Face : Status / -- / 100 : Lowers foe's Speed by 2
Screech : Status / -- / 85 : Lowers foe's Defense by 2
Shell Smash : Status / -- / -- : Raises user's Attack, Sp.Atk, and Speed by 2, at the cost of lowering its Defense and Sp.Def by 1
Slack Off : Status / -- / -- : Restores 1/2 of user's total HP
Sleep Talk : Status / 0 / 100 : Picks a random move of the user's to use if the user is sleeping
Smokescreen : Status / -- / 100 : Lowers foe's accuracy by 1
Splash : Status / -- / -- : This attack does nothing
Stockpile : Status / -- / -- : Raises user's Defense and Sp.Def by 1
Supersonic : Status / -- / 55 : Confuses foe
Swagger : Status / -- / 85 : Confuses foe, but raises foe's Attack by 2
Sweet Scent : Status / -- / -- : Lowers foe's Evasion by 2
Swords Dance : Status / -- / -- : Raises user's Attack by 2
Tail Whip : Status / -- / 100 : Lowers foe's Defense by 1
Teeter Dance : Status / -- / 100 : Confuses foe
Wish : Status / -- / -- : Heals a Pokemon by 50% of the user's max HP the next turn

===============
Poison
===============
Acid Armor : Status / -- / -- : Raises user's Defense by 2
Coil : Status / -- / -- : Raises user's Atk, Def, and Acc by 1
Gastro Acid : Status / -- / 100 : Supresses the foe's ability
Poison Gas : Status / -- / 80 : Poisons foe
Toxic : Status / -- / 90 : Badly poisons foe
Toxic Spikes : Status / -- / -- : Lays poisonous spikes on opponents side. 1 layer will cause any non-grounded foe switching in to be Poisoned, 2 = Toxic. POISON-types swtiching in removes them
Venom Drench : Status / -- / 100 : Lowers a Poisoned/Badly Poisoned foe's Attack and Sp.Atk by 2

===============
Psychic
===============
Amnesia : Status / -- / -- : Raises user's Sp.Def by 2
Calm Mind : Status / -- / -- : Raises user's Sp.Atk and Sp.Def by 1
Heal Pulse : Status / -- / -- : Heals foe by 50% HP
Healing Wish : Status / -- / -- : User faints. The next Pokemon sent in will be fully healed
Hypnosis : Status / -- / 60 : Causes foe to sleep
Light Screen : Status / -- / -- : Creates a screen that halves special damage on user's team for 6 turns
Lunar Dance : Status / -- / -- : User faints. The next Pokemon sent in will be fully healed
Psychic Terrain : Status / -- / -- : Changes the terrain to PSYCHIC for 8 turns
Reflect : Status / -- / -- : Creates a screen that halves physical damage on user's team for 6 turns
Rest : Status / -- / -- : Restores user's HP to full and clears any status conditions, and user falls asleep for 2 turns
Teleport : Status / -- / -- : User switches out, bringing in a teammate for free. This always moves last
Trick Room : Status / -- / -- : Speed order is reversed for 6 turns

===============
Rock
===============
Rock Polish : Status / -- / -- : Raises user's Speed by 2
Sandstorm : Status / -- / -- : Changes the weather to SANDSTORM for 8 turns
Stealth Rock : Status / -- / -- : Lays floating rocks on opponents side. Will damage any foe switching in (depending on their type weakness/resistance to ROCK) for a corresponding amount (1/2-1/32)

===============
Steel
===============
Automotize : Status / -- / -- : Raises user's Speed by 2
Iron Defense : Status / -- / -- : Raises user's Defense by 2
Load Firearms : Status / -- / 100 : Raises user's Speed and Accuracy by 1, and doubles the power of a STEEL move if used next
Magnet Rise : Status / -- / -- : User will float for 5 turns, causing it to be immune to all Ground-type attacks
Metal Sound : Status / -- / 100 : Lowers foe's Sp.Def by 2
Reboot : Status / -- / -- : Clears user or any Status condition, and raises user's Speed by 1
Shift Gear : Status / -- / -- : Raises user's Attack by 1 and Speed by 2

===============
Unknown
===============

===============
Water
===============
Aqua Ring : Status / -- / -- : Restores a small amount of HP at the end of every turn
Life Dew : Status / -- / -- : Restores 25% HP
Rain Dance : Status / -- / -- : Changes the weather to RAIN for 8 turns
Sparkling Water : Status / -- / -- : Raises Sp.Def by 1. Turns into Sparkling Aria when used by Kissyfishy-D
Water Flick : Status / -- / 100 : Lowers foe's Attack by 1. Turns into Flamethrower when used by Kissyfishy-D
Water Sport : Status / -- / -- : Makes FIRE moves deal 1/3 damage for 8 turns
Withdraw : Status / -- / -- : Raises user's Defense by 1
